F 70,70,70    
C 0,100,255
NO ./tx/n.xpm
EA ./tx/e.xpm
SO ./tx/s.xpm
WE ./tx/w.xpm

1111   111111111111111
1001   100000000000001
1001111100000000000001
1100000000000000000001111111
1110000000000000000001
1000000000000000000001
1000000000000000000001
10011000000N0000000001
1000000000000000000001
1000001100000000000001
1000000000000000000001
1000000110000000000001
1011110000000000000001
1000000000000000000001
1000000000000000000001
1001000000000000000011
1111111111111111111111